Govern ancient Sumer for 10 years...

The Codex of Hamurabi
A socioeconomic simulation by Bart Massey
Release 1 / Serial number 120128 / Inform 7 build 6G60 (I6/v6.32 lib 6/12N) SD
Copyright © 2012 Bart Massey; based on David Ahl's famous 1978 BASIC game HAMURABI, which was in turn a port of Doug Dyment's 1968 FOCAL game The Sumer Game.

Throne Room (on The Throne of Hamurabi)
Stone splendor stretches upward around your throne in this vast and echoing hall. Soft linen carpets, rich wood furniture, and gold accessories and ornaments adorn the richly tiled stone floor. Warm natural sunlight filters in through various high windows, contrasting pleasantly with the dim, cool surroundings.

Your Steward awaits your commands with quiet dignity.

>x me
You consider your stature, your grace and your excellence. You consider your garments: the linen skirt, chestplate, golden sandals and the ornate crown. You, Hamurabi, are clearly a destined ruler.

>i
You are carrying:
  a linen skirt (being worn)
  chestplate (being worn)
  golden sandals (being worn)
  an ornate crown (being worn)
  The Rod of Hamurabi

>x skirt
This is a simple linen garment, but the weave is incredibly fine and the needlework is impeccable. A stylish gold clasp closes the garment at the waist. Understated, but fit for a king.

* * *

>i
You are carrying:
  a linen skirt (being worn)
  chestplate (being worn)
  golden sandals (being worn)
  an ornate crown (being worn)
  The Rod of Hamurabi

>remove skirt. remove chestplate. remove sandals. remove crown.
You take off the linen skirt.

You take off chestplate.

(golden sandals)
You take off golden sandals.

You take off the ornate crown.

>x me
You consider your stature, your grace and your excellence. You consider your magnificent unclothed form. You, Hamurabi, are clearly a destined ruler.

>take all
The Staff of Stewardship: That seems to belong to the Steward.
The Annual Journal: That seems to belong to the Steward.
iron stylus: That seems to belong to the Steward.

>i
You are carrying:
  a linen skirt
  chestplate
  golden sandals
  an ornate crown
  The Rod of Hamurabi

>wear all
You can't use multiple objects with that verb.

>wear skirt. wear chestplate. wear sandals. wear crown
You put on the linen skirt.

You put on chestplate.

(golden sandals)
You put on golden sandals.

You put on the ornate crown.

>touch me
If you think that'll help.

* * *

>x me
You consider your stature, your grace and your excellence. You consider your garments: the linen skirt, chestplate, golden sandals and the ornate crown. You, Hamurabi, are clearly a destined ruler.

>remove linen skirt
You take off the linen skirt.

>x me
You consider your stature, your grace and your excellence. You consider your garments: chestplate, golden sandals and the ornate crown. You, Hamurabi, are clearly a destined ruler.

>remove chestplate, sandals and crown
You can't use multiple objects with that verb.

>remove all
You can't use multiple objects with that verb.

>remove chestplate; remove sandals; remove crown
I only understood you as far as wanting to remove chestplate.

>remove chestplate, remove sandals, remove crown
You can't use multiple objects with that verb.

>remove chestplate
You take off chestplate.

>remove sandals
(golden sandals)
You take off golden sandals.

>remove crown
You take off the ornate crown.

>x me
You consider your stature, your grace and your excellence. You consider your garments: . You, Hamurabi, are clearly a destined ruler.

* * *

>x Steward
This is the prime servant of The King; the man charged with carrying out the policies of Sumeria. He is wearing a modest tunic and leather sandals.

>x tunic
Tied at the waist with a fine braided leather belt, this garment is otherwise unadorned.

* * *

>x steward
This is the prime servant of The King; the man charged with carrying out the policies of Sumeria. He is wearing a modest tunic and leather sandals; he carries The Staff of Stewardship, The Annual Journal and an iron stylus.

>x leather sandals
These sandals are well-made but worn, evidently the property of a Steward who has walked Sumeria many times in the course of his duties.

>x staff
This elegant ebony staff reflects its utilitarian roots in the occasional well-patched scar. The Steward has been hitting things again, then.

* * *

>x steward
This is the prime servant of The King; the man charged with carrying out the policies of Sumeria. He is wearing a modest tunic and leather sandals; he carries The Staff of Stewardship, The Annual Journal and an iron stylus.

>x me
You consider your stature, your grace and your excellence. You consider your garments: a linen skirt, chestplate, golden sandals and an ornate crown. You are clearly a destined ruler.

>i
You are carrying:
  a linen skirt (being worn)
  chestplate (being worn)
  golden sandals (being worn)
  an ornate crown (being worn)
  The Rod of Hamurabi

* * *

>x skirt
This is a simple linen garment, but the weave is incredibly fine and the needlework is impeccable. A stylish gold clasp closes the garment at the waist. Understated, but fit for a king.

>x clasp
You can't see any such thing.

>x chestplate
This gold, bronze and iron chestplate is wrought with Depictions of the glory of Hamurabi.

>x Depictions
Gilt and finely-wrought reliefs of battle and of judgement, of honor and of power.

* * *

>x steward
This is the prime servant of The King; the man charged with carrying out the policies of Sumeria. He is wearing a modest tunic and leather sandals; he carries The Staff of Stewardship, The Annual Journal and an iron stylus.

>x staff
This elegant ebony staff reflects its utilitarian roots in the occasional well-patched scar. The Steward has been hitting things again, then.

>x journal
In this place, in this time, books have an almost palpable power. This one, for instance, chronicles the state of the Kingdom of Sumeria: its population and food supply, its immigration and death, its land and its inhabitants all the way down to the rats in the granaries.

>take journal
That seems to belong to the Steward.

>take staff
That seems to belong to the Steward.

>steward, give me the staff
The Steward has better things to do.

>ask steward about staff
There is no reply.

* * *

>x steward
This is the prime servant of The King; the man charged with carrying out the policies of Sumeria. He is wearing a modest tunic and leather sandals; he carries The Staff of Stewardship, The Annual Journal and an iron stylus.

>i
You are carrying:
  a linen skirt (being worn)
  chestplate (being worn)
  golden sandals (being worn)
  an ornate crown (being worn)
  The Rod of Hamurabi

>give rod to steward
The Steward doesn't seem interested.

* * *

>x steward
This is the prime servant of The King; the man charged with carrying out the policies of Sumeria. He is wearing a modest tunic and leather sandals; he carries The Staff of Stewardship, The Annual Journal and an iron stylus.

>x journal
In this place, in this time, books have an almost palpable power. This one, for instance, chronicles the state of the Kingdom of Sumeria: its population and food supply, its immigration and death, its land and its inhabitants all the way down to the rats in the granaries.

>x pages
These pages are sheets of purest gold, embossed by iron stylus with a record of the history of Sumer over a year's time.

* * *

>up
You cast your eyes up toward the Sumerian sun. For a moment, you imagine yourself as an egret, flying free in the wind. Sighing, you return to your duties as King.

>up
You shake your head at the obstinacy of your obligations, and continue to work.

>up
You shake your head at the obstinacy of your obligations, and continue to work.

>stand
You get off The Throne of Hamurabi.

Throne Room
Stone splendour stretches upward around your throne in this vast and echoing hall. Soft linen carpets, rich wood furniture, and gold accessories and ornaments adorn the richly-tiled stone floors. Warm natural sunlight filters in through various high windows, contrasting pleasantly with the dim, cool surroundings.

Your humble Steward awaits your commands with quiet dignity.

>sit
What do you want to sit on?

>sit throne
I didn't understand that sentence.

>sit on throne
You get onto The Throne of Hamurabi.

* * *

>stand
You get off The Throne of Hamurabi.

Throne Room
Stone splendour stretches upward around your throne in this vast and echoing hall. Soft linen carpets, rich wood furniture, and gold accessories and ornaments adorn the richly-tiled stone floors. Warm natural sunlight filters in through various high windows, contrasting pleasantly with the dim, cool surroundings.

Your humble Steward awaits your commands with quiet dignity.

>sit
(on The Throne of Hamurabi)
You get onto The Throne of Hamurabi.

>look
Throne Room (on The Throne of Hamurabi)
Stone splendour stretches upward around your throne in this vast and echoing hall. Soft linen carpets, rich wood furniture, and gold accessories and ornaments adorn the richly-tiled stone floors. Warm natural sunlight filters in through various high windows, contrasting pleasantly with the dim, cool surroundings.

Your humble Steward awaits your commands with quiet dignity.

>x steward
This is the prime servant of The King; the man charged with carrying out the policies of Sumeria.

>x steward's clothes
You can't see any such thing.

>x clothes
You can't see any such thing.

>look at steward
This is the prime servant of The King; the man charged with carrying out the policies of Sumeria.

>search steward
You find nothing of interest.

* * *

>x sapphire
This sapphire is the size of a plover's egg, and sparkles like a diamond in the night sky.

>x chestplate
This gold, bronze and iron chestplate is wrought with depictions of the glory of Hamurabi.

>x sandals
(golden sandals)
Gold and leather, with high laces and precious ornamentation.

>x laces
You see nothing special about laces.

* * *

>x skirt
This is a simple linen garment, but the weave is incredibly fine and the needlework is impeccable. A stylish gold clasp closes the garment at the waist. Understated, but fit for a king.

>x clasp
This clever wrought-gold hook clips the edges of the skirt together reliably.

>x sunlight
Very beautiful, and very appropriate to the space.

>north
You wander aimlessly around the Throne Room. So hard to concentrate. Oh well: that is the kind of thing, after all, that the Steward does admirably.

* * *

>down
You dream of going down among the people: of becoming one of them, merely a cog in the vast machine of Sumeria. Then you consider your position. Being a near-deity living in absurd luxury is, on reflection, a better course. You remain where you are.

>north
You get off The Throne of Hamurabi.

Throne Room
Stone splendour stretches upward around your throne in this vast and echoing hall. Soft linen Carpets, rich wood furniture, and gold accessories and ornaments adorn the richly tiled stone floor. Warm natural sunlight filters in through various high windows, contrasting pleasantly with the dim, cool surroundings.

Your humble Steward awaits your commands with quiet dignity.

You wander aimlessly around the Throne Room. So hard to concentrate. Oh well: that is the kind of thing, after all, that the Steward does admirably.

* * *

>north
(standing)
You wander aimlessly around the Throne Room. So hard to concentrate. Oh well: that is the kind of thing, after all, that the Steward does admirably.

>look
Throne Room
Stone splendour stretches upward around your throne in this vast and echoing hall. Soft linen Carpets, rich wood furniture, and gold accessories and ornaments adorn the richly tiled stone floor. Warm natural sunlight filters in through various high windows, contrasting pleasantly with the dim, cool surroundings.

Your humble Steward awaits your commands with quiet dignity.

* * *

>north
(standing)
You wander aimlessly around the Throne Room. So hard to concentrate. Oh well: that is the kind of thing, after all, that the Steward does admirably.

>north
You wander aimlessly around the Throne Room. So hard to concentrate. Oh well: that is the kind of thing, after all, that the Steward does admirably.

* * *

>n
(standing)
You wander aimlessly around the Throne Room. So hard to concentrate. Oh well: that is the kind of thing, after all, that your Steward does admirably.

>n
You start to head north, but you become distracted by the contemplation of your own greatness, and fall still.

>n
You decide that you can't leave now; there is too much to be done.

>n
You make a mental note to check out the north part of the room later.

>n
You make a mental note to check out the north part of the room later.

>s
You make a mental note to check out the south wall later.

>sw
You make a mental note to check out the southwest wall later.

* * *

>n
You make a mental note to check out the north part of the room later.

>nw
You make a mental note to check out the northwest part of the room later.

* * *

>take ornaments
Very beautiful, and very appropriate to the space.

You leave things where they are.

* * *

>take carpet
You can't see any such thing.

>take carpets
Very beautiful, and very appropriate to the space.

You leave things where they are.

* * *

>take carpets
These things have resided here for a thousand years. You leave them where they are.

* * *

>x ornament
Very beautiful, and very appropriate to the space.

>take chair
These things have resided here for a thousand years. You leave them where they are.

>x light
Very beautiful, and very appropriate to the space.

>x sunlight
Very beautiful, and very appropriate to the space.

* * *

>x light
The shafts of sunlight adorn the Throne Room with an appropriate grace

>x windows
The windows glow with the promise of your inevitable ascension.

>x window
The windows glow with the promise of your inevitable ascension.

>take window
These things have resided here for a thousand years. You leave them where they are.

* * *

>take window
No glass. No frame. Just a hole. You take the window, but only in the abstract sense of possession; the window's emptiness is now yours.

>take light
Wouldn't it be nice to be able to pocket some sunlight for the dark nights and cold winters? But it is not to be. The tighter you squeeze, the more it slips through your fingers.

>take ornament
These things have resided here for a thousand years. You leave them where they are.

* * *

>x clothes
You can't see any such thing.

>x my clothes
You can't see any such thing.

* * *

>x steward's clothes
You can't see any such thing.

>x steward
This is the prime servant of The King; the man charged with carrying out the policies of Sumeria. He is wearing a modest tunic and leather sandals; he carries the Staff of Stewardship, the Annual Journal and the iron stylus.